#######################################################################
#################             ?                ########################
#############               #################  ########################
#############   ###        ################### ########################
############### ###?###################  ##### ########################
############### ###            ?         ##### ########################
############### ################         #####                       ##
###############             ###          #########################   ##
#########                                ######################    # ##
#########               ###############           ###########     ## ##
#######                   ##########                  ######     ### ##
######                    #########                     ############ ##
#######                 #########                         ########## ##
################################                            ######## ##
###############################                               ###### ##
####################                                           ##### ##
##############             ##                                   #### ##
##########              #####                                   #### ##
###2                 #######                                    #### ##
####                 #########                                ###### ##
#############?##################                            ######## ##
############# #####################                       ########## ##
#############?#######################               ################ ##
#############            ###########                 ############### ##
#############  #######  ###########                 ################ ##
#############  #######   #########                ################## ##
#############  #######  ####                        ################ ##
############    ######  ###                        ################# ## 
##########        ####  #####                      ################# ##
###                 ##  ######                    ################## ##
##                   #                                         ##### ##  
##                  ##  ###########B                            #### ##  
##                   #    #######                                  #@## 
##                   #  #######                                     ?##
##                   #                                            ##### 
##                   ########                                      ####
##### ######################                                       ####  
#####      ###       #    ############# #########    ##################
#####                     ##      # ##############  ###################  
#####                             ?                 ###################
#######################################################################  