#######################################################################
#                                >                                    #
#                                                                     #
#                                 @                                   #
#                                                                     #
#       #+######################## ############################       #
#       #          ##     ##             ##            #      #       #
#       #           #      ##           ##             ###    #       #
#       ########### #       ##         ##                     #       #
#       #           #        ##       ##               # #### #       #
#       # ###########         ##     ##                #      #       #
#       #           +          ##   ##                 #### ###       #
#       #############           ## ##                     ### #       #
#       #                        # #                          #       #
#       #                                                     #       #
#       #                                           ###########       #
#       #                                           #         #       #
#       #                                           #         #       #
#       #                                           #         #       #
#       #                        ###                #         #       #
#       #                       ## ##               #         #       #
#       #                      ##   ##              #         #       #
#       #                     ##     ##             ########+##       #
#       #                    ##       ##                      #       #
#       #                   ##         ##                     #       #
#       #                   #     #     #                     #       #
#       #                   ##         ##                     #       #
#       #                    ##       ##                      #       #
#       #                     ##     ##                       #       #
#       #+##                   ##   ##                        #       #
#       #  #                    ## ##                         #       #
#       #  #                     ###                          #       #
#       #  #                                                  #       #
#       #  #                                                  #       #
#       #  #                                             ######       #
#       #  #                                            ##    #       #
#       #  #                                           ##     #       #
#       #  #                                           +      #       #
#       #####################################################+#       #
#                                                                     #
#######################################################################