                                                 #
          ##################                     #
          #??  1#?? 2#              ??           #
####      #     #    #3   3#                     #
#         #     #          #                     #
#  #            #          #                     #
#@ #      #     #2   #3    #                     #
####      #1         #     #                     #
          ##################                     #
                                                 #
                                                 #
                #                   3            #
               ###                 333           #
              #####               33333          #
##################################################