#######################################################################
#~~~~~~~~~~~~~~~~~~~~~~~~~~~~~~~~~~~~~~~~~~~~~~~~~~~~~~~~~~~~~~~~~~~~~#
#~~~~~~C.....                                       ^^^^^^^           #
#~~~~~~......                                      ^^*****^^          #
#~~~~~~....@.                                     ^^*******^^         #
#~  .........                                    ^^*********^^        #
#~                                              ^^^^^^^^^^^^^^^       #
#                                              ^^^^^^^^^^^^^^^^^      #
#                                             ^^^^^C^^^^^^^^^^^^^     #
#                                            ^^^^^^^^^^^^^^^^^^^^^    #
#                                                                     #
#                                                                     #
#                                                                     #
#                                                                     #
#                                                                     #
#                                                                     #
#                                                                     #
#                                                                     #
#                                                                     #
#                                                                     #
#                                                                     #
#                                                                     #
#                                                                     #
#                                                                     #
#                                                                     #
#                                                                     #
#                                                                     #
#                                                                     # 
#                                                                     #
#                                                                     #
#                                                                     #  
#                                                                     #  
#                                                                     # 
#                                                                     #
#~~~~%%%%%%%                                                          # 
#~~~~%%%%%%%%                                                         #
#~~~~%%%%%%%%%                                                        #  
#~~~~%%%%%%%%%%                                                       #
#~~~~                                                                 #  
#~~~~                                                                 #
#######################################################################  