##################
#^^^F%~~~~~~~~~~~#
#^^^%%~~~~~3~~~~~#
#^4^@1~~~~~~~~~~~#
#^^^%%%~^^^^^^^%~#
#FF^^^%~FF^^^FF%~#   
#2FFFF%~FF^^^FF%~#
##################